base layer
16$16
1111111111111111
1111111111111111
1111111111111111
2221222212221111
2221222212221111
2221221112221111
2221221112221111
2221222112221111
2221222112221111
2221221112221111
2221221112221111
2221222212221111
2221222212221111
1111111111111111
1111111111111111
1111111111111111

