base layer
16$16
0000000000000000
0000000000000000
0000000000000000
0000333333000000
0000311113000000
0000311113000000
0000311113000000
0000311113000000
0000311113000000
0000311113000000
0000333333000000
0000333333000000
0000000000000000
0000000000000000
0000000000000000
0000000000000000

